15
17
11111111111111111
10000000000000001
10100111100100101
10000111100000001
10100000000111101
10001000010000001
10100000101000001
10001000101001001
10100000101000001
10000000000001001
10111000000000001
10111000111111101
10000000000000001
10000000000000001
11111111111111111